111111111
1000101C1
100E00101
11110PC01
100101001
1011C1001
111111111
