11111111111111111111
10000000100000000001
100010001000C1000001
10111011111111000001
1C001000000000011101
11111111111000001111
100C1000000000001CE1
10001001111111111001
101111000000P0001001
1000C000001100000001
11111111111111111111
