111111111111
100000000001
100100111101
10010010E001
10010P100001
100111111111
100000000001
111111111111
