111111111111
1C0000000001
100100111101
10010C101001
10010P1000C1
100111111111
1C000000C001
111111111111
