111111111111
1C0000000001
100100111101
10010C10E001
1001001000C1
100111111111
1C000000C001
111111111111
